20 20
####################
#......#############
#..#.#.............#
####.###############
#..................#
#..................#
#..................#
#..................#
#..................#
#..................#
#..................#
#...L..............#
#..................#
#########X##########
#........T.........#
#..................#
#..................#
#..................#
#..................#
####################
Character Peter @ 5 5 ConsoleController 9 9
Character Hans % 2 2 StationaryController 3 4
Item Greatsword 16 4
Door 13 9 Lever 11 4
