12 20
####################
#..................#
#..................#
#..................#
#..................#
#########D##########
#..................#
#.............L....#
#..................#
#..................#
#..................#
####################
Character Peter @ 5 5 ConsoleController 9 9
Character Hans % 1 1 StationaryController 4 9
Item Greatsword 9 4
Item Greatsword 10 15
Door 5 9 Lever 7 14
